________ 
|______ |
||____ ||
|||__ |||
|||| ||||
|||||||||
||||L||||
|||L__|||
||L____||
LL______|
1 1 0