________ 
|       |
|       |
|       |
|       |
|       |
|       |
|       |
L_______|
1 1 0